----#---
---####-
--#-----
--####--
--#--#--
--#-##--
---#----
-#---#--