-----------------
-#-------------#-
--#-----------#--
---#---------#---
----#-------#----
-----#-----#-----
-----------------
-------#-#-------
--------#--------
--------#--------
--------#--------
-###############-
--------#--------
--------#--------
--------#--------
--------#--------
--------#--------