--------
-######-
------#-
------##
--------
--------
--------