--#####--
#-----#-#
#-###----
#-#-#####
--#-----#
#-#####-#
---------