###############------------------#--
#-------------------###-----###----#
#--######--######-------##---------#
#--######--######----#####-----####-
#-------#--------------##---------#-
#####---#--##############--#######--
#---------##---------------##----#--
#--###################------##----#-
#------------------------######----#
#--#####--######-------------#---#--
#--#####--######--############---#--
#---------#----------#------#-----#-
#######---#--#########------#-####--
#-----------#-----------#----------#
######--############--########--##--
#------------#-----------------#-#--
#-########---#---######-------#--#--
#----------------------#----------#-
##########---############---#####---
#----------------------#----------#-
#-#####--#################--#####---
#-#####---------------------#----#--
#-##---------#########------#-##-#--
#-##---##------------------------#--
#--------##--#########------##---#--
####--#################--#####---#--
#----------------------#----------#-
#--##########---##########---####---
#--------------#-----------------#--
##################################--